WE tests/textures_blue/blue2.xpm
EA tests/textures_blue/blue3.xpm
NO tests/textures_blue/blue1.xpm
SO tests/textures_blue/blue4.xpm
DO tests/textures_classic/eagle.xpm
SK tests/textures_blue/sky_test.xpm
F tests/textures_blue/floor_stone.xpm
C tests/textures_blue/ceiling_panel.xpm

111111111111111111111111
100000000000000000000001
1000000000000000N0000001
100000000000000000000001
100000111112111111000001
100000100000000001000001
100000100000000001000001
100000100000000001000001
100000111111111111000001
100000000000000000000001
100000000001000000000001
100000100000000010000001
100000100001000010000001
100000100000000010000001
100000000001000000000001
100000000000000000000001
111111111111111111111111
