WE tests/textures_blue/blue2.xpm
EA tests/textures_blue/blue3.xpm
NO tests/textures_blue/blue1.xpm
SO tests/textures_blue/blue4.xpm

DO tests/textures_classic/eagle.xpm

SP tests/textures_blue/test_sprite.xpm
SP0 tests/textures_blue/sprite_dir_0.xpm
SP1 tests/textures_blue/sprite_dir_1.xpm
SP2 tests/textures_blue/sprite_dir_2.xpm
SP3 tests/textures_blue/sprite_dir_3.xpm
SP4 tests/textures_blue/sprite_dir_4.xpm
SP5 tests/textures_blue/sprite_dir_5.xpm
SP6 tests/textures_blue/sprite_dir_6.xpm
SP7 tests/textures_blue/sprite_dir_7.xpm

TR tests/textures_blue/glass_wall.xpm
DC tests/textures_blue/wall_decal.xpm

F tests/textures_blue/floor_stone.xpm

C tests/textures_blue/ceiling_panel.xpm

111111111111111111111111
1000000000000000000000X1
1000000000000000N0000001
100000000000000000000001
100000111112111111000001
100000100000000004030001
100000100033333335000001
100000100000000001000001
100000111111411111000001
100000000000000000000001
100000000001000000000001
100000100000000010000001
100000100001000010000001
100000100000000010000001
100000000001000000000001
100000000000000000000001
111111111111111111111111
