
WE tests/textures_blue/blue2.xpm
EA tests/textures_blue/blue3.xpm
NO tests/textures_blue/blue1.xpm
SO tests/textures_blue/blue4.xpm
DO tests/textures_classic/eagle.xpm

F 31, 18, 106
C 248, 249, 252

111111111111111111111111111111111
100000000000000000000000000000001
100000000000000000000000000000001
100000000000000000000000000000001
100000000000000000000000000000001
100000000000000000000000000000001
100000000000000000000000000000001
100000000000000000000000000000001
100000000000000000000000000000001
10000000000000N000000000000000001
100000000000000000000000000000001
100000000000000000000000000000001
100000000000000000000000000000001
100000000000000000000000000000001
100000000000000000000000000000001
100000000000000000000000000000001
100000000000000000000000000000001
100000000000000000000000000000001
111111111111111111111111111111111