

SO tests/textures_classic/redbrick.xpm

WE tests/textures_classic/greystone.xpm

EA tests/textures_classic/bluestone.xpm

NO tests/textures_classic/colorstone.xpm

DO tests/textures_classic/eagle.xpm

F 7, 0, 77

C 25,25,25

111111111111111111111111111111111
        1111111111111111111111111
        1000000000110000000000001
        1011000001110000000000001
        1001000000000000000000001
111111111011000001110000000000001
100000000000000001110111111111111
11110111111111011100000010001
111121011111111101110101001001
11000000111010111000000100011
100000000000001100000010001
100000000000000110101000001
1100000110101111110111100111
1100E001 1110101 10111101111
11111111 1111111 11111111111
